R 1280 720
NO ./img/NO.xpm
SO ./img/SO.xpm
WE ./img/WE.xpm
EA ./img/EA.xpm

S_Y ./img_bonus/피카츄.xpm
S_Y2 ./img_bonus/피카츄2.xpm
S_R ./img_bonus/파이리.xpm
S_R2 ./img_bonus/파이리2.xpm
S_G ./img_bonus/이상해씨.xpm
S_G2 ./img_bonus/이상해씨2.xpm
S_B ./img_bonus/꼬부기.xpm
S_B2 ./img_bonus/꼬부기2.xpm

F ./img_bonus/floor.xpm
C ./img/skybox.xpm

111111111111111111111
100000000000000000001
100000000000000R00001
100000000000E00G00001
100000000000000B00001
100000000000000Y00001
100000000000000000001
111111111111111111111
