R 1280 720
N ./map/bonus3.cub
NO ./img/NO.xpm
SO ./img/SO.xpm
WE ./img/WE.xpm
EA ./img/EA.xpm

S_Y ./img_bonus/피카츄.xpm
S_R ./img_bonus/파이리.xpm
S_G ./img_bonus/이상해씨.xpm
S_B ./img_bonus/꼬부기.xpm
S_H ./img_bonus/potion.xpm
S_O ./img_bonus/오박사.xpm

F ./img_bonus/floor.xpm
C ./img_bonus/skybox.xpm

111111111111111111111
100000000000000H00001
100000000000000B00001
100000000000E00G00002
100000000000000R00001
100000000000000Y00001
100000000000000O00001
111111111111111111111
