R 720 480
NO ./img/NO.xpm
SO ./img/SO.xpm
WE ./img/WE.xpm
EA ./img/EA.xpm

S ./img/ITEM.xpm
F ./img/FLOOR.xpm
C ./img/skybox.xpm

        1111111111111111111111111
        1000000000110000000000001
        1011000001110000000000001
        10010000000000E0002000001
111111111011000001110000000000001
100000000011000001110111111111111
11110111111111011100000000001
11110111111111011101010000001
11000000110101011100000010001
10000000000000001100000010001
10000000000000001101010010001
1100000111010101111101111000111
11110111 1110101 10111101001
11111111 1111111 111111111111
