R 1280 720
N ./map/bonus2.cub

NX ./img_bonus/nextlevel.xpm
NO ./img/NO.xpm
SO ./img/SO.xpm
WE ./img/WE.xpm
EA ./img/EA.xpm

S_Y ./img_bonus/피카츄.xpm
S_R ./img_bonus/파이리.xpm
S_G ./img_bonus/이상해씨.xpm
S_B ./img_bonus/꼬부기.xpm
S_H ./img_bonus/potion.xpm
S_O ./img_bonus/오박사.xpm

F ./img_bonus/floor.xpm
C ./img_bonus/skybox.xpm

1111111
1000001
1000001111111111111111111111111111111111111111111111111111111111111111
10E0000000000000011111111111R0000000000000000000000000000000000H111111
10000O1111111111011111111111011111111111111111111111111111111110111111
1000001 11111111011111111111011111111111111111111111111111111110111111
1000001 11111111011111111111011111111111111111111111111111111110111111
1111111 11111111011111111111011111111111111111111111111111111110111111
        11111111011111111111011111111111111111111111111111111110111111
        11111111011111111111011111111111111111111111111111111110111111
        11111111011111111111011111111111111111111111111111111110111111
        111111110000000000000111111111B0000000000000000000000000111111
        11111111111111111111011111111101111111111111111111111111111111
        11111111111111111111011111111101111111111111111111111111111111
        11111111111111111111011111111101111111111111111111111111111111
        11111111111111111111011111111101111111111111111111111111111111
        11111111111111111111011111111101111111111111111111111111111111
        11111111111111111111011111111101111111111111111111111111111111
        11111111111111111111011111111101111111111111111111111111111111
        11111111111111111111011111111101111111111111111111111111111111
        11111111111111111111G11111111100000000000000000000000000111111
        11111111111111111111111111111111111111111111111111111110111111
        11111111111111111111111111111111111111111111111111111110111111
        11111111111111111111111111111111111111111111111111111110111111
        11111111111111111111111111111111111111111111111111111110111111
        11111111111111111111111111111111111111111111111111111110111111
        1111111111111111111111111111111111111111111111111111111Y000002
        11111111111111111111111111111111111111111111111111111111111111
