R 720 480
N FINISH
NX ./img_bonus/nextlevel.xpm
NO ./img/NO.xpm
SO ./img/SO.xpm
WE ./img/WE.xpm
EA ./img/EA.xpm

S_Y ./img_bonus/라이츄.xpm
S_R ./img_bonus/리자몽.xpm
S_G ./img_bonus/이상해꽃.xpm
S_B ./img_bonus/거북왕.xpm
S_H ./img_bonus/potion.xpm
S_O ./img_bonus/오박사.xpm

F ./img_bonus/floor.xpm
C ./img_bonus/skybox.xpm

111111111111111111111111111111111111
1B0000000000000000000000000000000001
1111111100000000000000001110000000O1
100000010000000000000000001E00000002
1G0001000000000000000000000000001001
111101110000000000000000111111001001
111101110000000000000000111111001001
111101110100001010101000111111001001
111101110011001010101000111111001001
111101110000101010101000111111001001
11110111000001R000000000111111001001
111101110100001001000000111111001001
111101110100100001010000111111001001
111101110100100001010000111111001001
111101110000101000011000111111001001
111101110100001000001000111111001001
111101110100001000001000111111001001
111101110100100010010000111111001001
111101110000100010010000111111001001
111101110000100010010000111111001001
10000000000000000000000001H000010Y1
111111110000000000000000111111111111
111111111111111111111111111111111111
